1111111111111111111
10P00000C0000001111
1001011111000001111
10010000C0000001111
1001000000001E11111
100011111010C100001
1111111111111111111