1111111111111111111
10P00000C0000001111
1001011111000001111
10010000C0000001111
10010000C0000001111
10010000C0000001111
10010000C0000001111
10010000C0000001111
10010000C0000001111
10010000C0000001111
10010000C0000001111
10010000C0000001111
10010000C0000101111
10010000000011E1111
100011111010C1C0C01
1111111111111111111