11111111
11111111
1P0CEC01
11111111
11111111