1111111111111111111
10P00000C0000001111
1001011111000001111
10010000C0000001111
1001000000001011111
100011111010C00E0C1
1111111111111111111