1111111111111111111111111
1P00000000001C0010C000001
1011110111100110111110101
1000000100000C00000000101
1011110111110111111100101
1000C1000C000000000000101
1011111101111110111111101
1000000100000000100000001
1011100101111110101111101
1000100000000010000000101
10101111111C1110111101101
1000000000100010000100001
1011101110101010101110101
1000100000100000100000101
1110101111111111110101011
100000010000000010000C001
1011110101111110111110101
1000000000100000000000101
1011110111101111111100101
10000C0000000000000000101
1011111111110111111111001
10C0000000C00000000000011
1011111111111011111111111
1000000100000C000000000E1
1111111111111111111111111