11111111111111111111111111111111111111
1P000000000010001000000010000000000011
10111101111001101111101010000000000011
10000001000000000000001010000000000011
10111101111101111111001111111111101111
10000100C0000C0000C0001010000000000001
10111111011111101111111011111010111011
10000001000C0000100000001C0C0C00001001
10111001011111101011111010000C00C01001
1000100000000010000000101111E111111111
111010111CC0CC0111010000000000000C0001
11111111111111111111111111111111111111