1111111111111111111111111
1P00000000001000100000001
1011110111100110111110101
1000000100000000000000101
1011110111110111111100101
1000010000000000000000101
1011111101111110111111101
1000000100000000100000001
1011100101111110101111101
1000100000000010000000101
1010111111110110111101101
1000000000100010000100001
1011101110101010101110101
1000100000100000100000101
1110101111111111110101011
1000000100000000100000001
1011110101111110111110101
1000000000100000000000101
1011110111101111111100101
1000000000000000000000101
1011111111110111111111001
1000000000000000000000011
1011111111111011111111111
100000010010000000000CE11
1111111111111111111111111