111111111111
10PCCE000001
111111111111