111111111111111111111111
10P000010C000000M0000001
10000001C000000M00000001
100C00C0000CMC00000000E1
111111111111111111111111