111111111111111
1P0000000000001
101111011111101
100C0000C000001
101111011111101
100000000000001
111011111110111
1C00000000000C1
111011111110111
100000000000001
101111011111101
100000C00C00001
101111011111101
1E0000000000001
111111111111111