111111111111111111111
1P0000000000000000E01
101111011111011111101
1C00M000C0M00C0000C01
101111011111011111101
100000000MM0000000001
111011111110111011111
1C000000000M0000000C1
111011111110111011111
10000000M0M0000000001
101111011111011111101
1C000000C0000C0000C01
101111011111011111101
1M000000000M000000001
101111011111011111101
10000000MM00000000001
1C000000C0000C0000C01
101111011111011111101
100000000M00000000C01
111111111111111111111