1111111111111111111111111111111111111
1P0M00000100010000M001000000000001111
10M0000001000000000000000000000000001
10000001000000M000000010100000M000001
1011110111110111111100111111111101111
10000100C0000C0000C00010100000M000001
1011111101111110111111101111010111011
10000001000C00001000M0001111C00001001
101110010110111010111110M1C10000M0001
10001000M00C0010000000111100000000111
111010111CC0CC0111010000010M00000E001
1111111111111111111111111111111111111