11111111111111111111111111111111111111
1PC000000000100010000M001000000M000011
1011110111100110111110101MMMMMMMMMMM11
10000001000000M000000010100000M0000011
10111101111101111111001111111111101111
10000100C0000C0000C000101000000M000001
10111111011111101111111011111010111011
10000001000C00001000M0001C0C0C00001001
101110010110111010111110000M0C0MC01001
10001000M0000010000000101111E111111111
111010111CC0CC011101000000M1M100000001
11111111111111111111111111111111111111